1111111111
1CP000E011
100C0C0111
1111111111
